XXXXXXXXXXXXXXXXXXXX
XXXRRRV||||||||||||X
X|VRCRXX|XXX|XX|X|XX
X|XRRRX||X|||X||X|XX
X|XXHXXXXX|XXXXXX||X
S|||||||||||||||||XX
XXXX|X|XXXXX|XXXXXXX
XX|X|X|X|||||||||||X
X||||X|X|XXX|XXXHXXX
X|XX|X|X|||X|XRRRRRX
X|XX|X|XXXXX|VRRCRRX
X||X|X||X||X|XXXXXXX
XXXX|XXHXX|X|||||||F
XRRX|XRRRX|XX|XXXXXX
XRCV|XRCRX||||XXRCRX
XRRX|VRRRXX|XXXXXHXX
XXXX|XRRRXX||||||||X
X||||XXDXXXXXXXXX|XX
X|XX||||||||||||X||X
XXXXXXXXXXXXXXXXXXXX

